WWWWWWWWWWWWWWWWWWWWWWWWW
W                       W
W         WWW           W
W         WCW           W
W         W W           W
W         W W           W
W         W W           W
W         WCW           W
W         W W           W
W         W W           W
W         W W           W
W         W W           W
W         W W           W
W         W W           W
W         W W           W
W         W W           W
W         WSW           W
W         WWW           W
W                       W
W                       W
W                       W
W                       W
W                       W
W                       W
WWWWWWWWWWWWWWWWWWWWWWWWW
