WWWWWWWWWWWWWWWWWWWWWWWWW
W                       W
W         WWW           W
W         WSW           W
W         W W           W
W         W W           W
W         W W           W
W         W W           W
W         W W           W
W         W W           W
W         W W           W
W         W W           W
W         W W           W
W         W W           W
W         W W           W
W         W W           W
W         WCW           W
W         WWW           W
W                       W
W                       W
W                       W
W                       W
W                       W
W                       W
WWWWWWWWWWWWWWWWWWWWWWWWW
